Time,Money-In,Money-Out,Balance,Txid,Block
2017-03-29 09:12:57,1.0,0.0,1.0,0faa35c581e176be49b119d21ec3aacf36175af4dfb485ce67c9c27869d3aedc,459440
2017-03-29 09:43:54,1.0,0.0,2.0,612f0b90a7674b176d637a0e116fec2051678769d38cf58eb777d8992649db11,459443
2017-03-29 10:16:15,0.0,1.0,1.0,ed80675b84c2e4709ce9e984cb9a0fc8d1426e8bdf5cbcba56622f1102005c7e,459445
2017-03-29 10:16:15,0.0,1.0,0.0,ed80675b84c2e4709ce9e984cb9a0fc8d1426e8bdf5cbcba56622f1102005c7e,459445
2017-04-03 06:32:22,1.0,0.0,1.0,fbaafdf51456f3c3a4e4f4bb4936d2e21974a2d5686fab13e08bcc0c874118e9,460169
2017-04-03 07:42:45,0.6,0.0,1.6,bd9d232fdff696d2d7704c1f9a89cf46bafc52f7e8d4c74b9c85c0c4ada0592f,460175
2017-04-03 08:28:17,0.0,0.6,1.0,ad97e17594829ce3a9f2449ea373ae2946ad78fd03d1d039763c6ee7b4fe2a6e,460177
2017-04-03 08:28:17,0.0,1.0,0.0,ad97e17594829ce3a9f2449ea373ae2946ad78fd03d1d039763c6ee7b4fe2a6e,460177
2017-04-27 09:07:08,0.62,0.0,0.62,8f9f27b1690b081f6a9d31dac1331da9e97877e1a27ebbcf6809435889bf7a88,463710
2017-04-27 09:41:36,0.0,0.62,0.0,37f45c6e94faa4722deb6d69aea2f2ecb3f3cdfb3c7893ab281bd25a2c982699,463713
2017-05-20 03:11:21,2.23851031,0.0,2.23851031,9213385a68a97d35b9470f11ce3531448995505d8f70a4803ae7ff0ba0521e69,467212
2017-05-20 04:19:57,0.0,2.23851031,0.0,4b3b98dc6069e27a3a25129c93cc19517948765a9d91d20fe221e576676b3492,467218
2017-05-22 09:04:37,5.18813199,0.0,5.18813199,cd29f008c72e863864404d064873e7ff6d24cdc7891146040184bbaa77e1d783,467555
2017-05-22 09:16:11,0.0,5.18813199,0.0,81183cffb075adbbdf838467705e6488393988ce291c3c000bfc47cb23b60654,467556
2017-05-24 00:31:13,0.19,0.0,0.19,21245fab02a105dd885b2057e9993a683556afd59c22e22b66ad8116cac94518,467819
2017-05-24 00:54:29,0.0,0.19,0.0,05dbb94d08532ec14bb43de04672fec1cf7b46898142cf2e2fa4b4b099c9432a,467823
2017-05-24 06:42:06,2.50737246,0.0,2.50737246,d958bbc5bf87c6b58c480513818ad9c177c4e896b55bed8c2e662d5efdbf3d1e,467857
2017-05-24 06:51:10,0.0,2.50737246,0.0,b64ec786d8cd20a1ff1c6836583990ade0a963066bebe4edb39717bbd26e0c5f,467858
2017-05-24 13:02:12,2.07989525,0.0,2.07989525,22b09c0ef4f03673fbd3307f265b1c79943a09c7d5603ab54a651af47a3229da,467889
2017-05-24 13:45:03,0.0,2.07989525,0.0,911a067e95421aa0eb0016a4d2d3d1fafa411c8ca1b6021b085682f2caab1910,467899
2017-05-25 04:36:00,1.58331321,0.0,1.58331321,719a40e7c7a57210d8743dc64a79e1e05dcbadeed3c7b8666efa5a4e4d09a7cc,468007
2017-05-25 12:12:10,0.0,1.58331321,0.0,c2528d20662dae233bd2055fe4e87ed73479c263876556d082efb1ef5aef2b62,468054
2017-05-27 07:20:24,1.47142833,0.0,1.47142833,7a75d424f61a8a042b45746db843ee8a912a91d9720d4f17152a338da7f9240b,468330
2017-05-27 11:33:44,0.0,1.47142833,0.0,761c5488b3dcb87ef18930c5fecc5d264f000b75dd21668cb85af845122f7db8,468356
2017-05-31 03:44:38,0.19,0.0,0.19,052bcf65d3d6a06ce5b92ad211b0770cd703537db534bb74934d0b792d4a12d9,468984
2017-06-01 03:55:11,1.94382743,0.0,2.13382743,aa9ebc09ed8b728b26c94353c4f58249793870a5d0ec718c38dfbb805b771c99,469146
2017-06-01 08:11:05,2.12772284,0.0,4.26155027,f9639abf8399ce0c3032114350119602a030636f645fc2d5d710a3ad10e7db9e,469176
2017-06-01 17:38:58,2.29468949,0.0,6.55623976,be1f6227daafc3a04d2fd0c57e4869ffc037a9bca23fa0e416efef67aa9ec54b,469236
2017-06-01 18:28:37,0.0,0.19,6.36623976,d99b4767d3ae2815d7378e26192b8325b838eb83447fad56699d9e87b0362ad0,469246
2017-06-02 04:28:13,2.26391949,0.0,8.63015925,ba4a395212b32d25461fd1264582d4b6322e3a6abb69d38109f8974525be5f54,469307
2017-06-02 04:55:42,0.0,1.94382743,6.68633182,d1fadaf7e7a81d937c72480922b247822061857a54805d8bc55d0d50a1635b7f,469310
2017-06-02 08:06:39,0.0,2.12772284,4.55860898,59d319101e8e3e104eee1e6e66381b765c9dc7e5cbd8e7ea292ce6ddc83219c4,469332
2017-06-02 08:59:13,0.0,2.26391949,2.29468949,d17d9077329ddbb388d7328c59e7b1ebc8612a08a300a8c269f98838d63afa73,469337
2017-06-02 10:42:46,0.0,2.29468949,0.0,03577197a1d171bb597d6c5e8fe047d08615456df48b59011049c819fc4e8322,469346
2017-06-02 11:10:06,1.26327187,0.0,1.26327187,51264ed32bfe352d89941e8a755d886a651efd4e1285a7f99a85132673d65b90,469350
2017-06-02 11:36:32,0.0,1.26327187,0.0,e2ecd3e145547a68a9e15d34cebbc7fb87f087f4470cff6f4a123685cf3e63f1,469354
2017-06-03 05:57:53,1.84382922,0.0,1.84382922,7e0a9beb46012f681cc00a22b92e0008b7b9208adf1f0782a5b8ba8432cffd5e,469483
2017-06-03 06:23:07,0.0,1.84382922,0.0,3ee2a07d166a9ce386f2d3eb6aaf3c70f0b8a99b4a7ab7809a069db0bc01fc71,469492
2017-06-11 22:13:19,0.49,0.0,0.49,ffce4931ef07ecd61a2e40e6e707d12fcf2722ecf4661e2380eb1956a8c2bb6f,470853
2017-06-11 22:28:36,0.0,0.49,0.0,f777c49dc4a5f7cd75129d53141a18cdda0a83d6c68060bedca352dfc2918d53,470859
2017-06-15 02:55:40,0.29725345,0.0,0.29725345,65c1acabbb808e14660ab181b29a3ebc3c7b7913ee90c30bf472913f8a770680,471312
2017-06-15 03:31:30,0.0,0.29725345,0.0,e7f59cbfa08a971b25d4f3db2b9ad5bffa8331f1f560f67371649c573c05c4d7,471317
2017-06-15 06:34:00,3.65544638,0.0,3.65544638,e608ff9a5a2db285071000229e88b99cacf744bedf9113ffabc8d362f76c5069,471342
2017-06-15 07:34:14,0.0,3.65544638,0.0,f46a4c9cee3e065765771df169babecb10331e99460e1dfd6f8a020bf381aece,471349
2017-06-15 09:03:09,3.1212022,0.0,3.1212022,3c3dd6e7a6673e9dc262e725d6b69b3d5a6d6a14a475fd4585f1502df7c48dec,471356
2017-06-15 09:23:27,0.0,3.1212022,0.0,e3b72afbcf8e7799d12db5cbf65373be8aa04ef33c57dc59874bcee217ed0e00,471358
2017-06-17 07:46:03,5.52426349,0.0,5.52426349,a85d40ce7c097098351a5d60457008515f6e41b34aa61eb783717df5d7dbb51f,471642
2017-06-17 09:05:32,0.0,5.52426349,0.0,bae3411839b3afe73695641f9652bf46fa2956f20a3c2b400e16021eabb6d326,471653
2017-06-20 08:33:41,3.35421759,0.0,3.35421759,0f2b5834ff7291eb0062b291deaf644f270d376beba209da7bed32d635be89af,472087
2017-06-20 09:17:23,0.0,3.35421759,0.0,fd2bbae6dabbf87d141ae5f7b0890f6042ae6943ba3ac85bb03ea8376a80526b,472090
2017-06-21 07:40:16,0.24,0.0,0.24,b1e938c62bae63e566be5b40ba29db8e293930421768aaa161093bfb41f41b72,472219
2017-06-21 08:07:08,0.0,0.24,0.0,2a3d582edf34777cd792708b2f7eb3677821ac28f48e10b8c68e3fa0792b5ce9,472222
2017-06-21 08:56:09,3.01645576,0.0,3.01645576,996dbf65974e644fdb18e7eb83503104166863cbbe73d5cc507c7688f0c023e3,472227
2017-06-21 09:58:12,0.0,3.01645576,0.0,98510942852a5087997898ffda21fae4165a03054d634099ba9952980d5a2de7,472232
2017-06-27 10:31:11,3.03208835,0.0,3.03208835,7dfba2a440393a5f48c500331d4b3933eaaf86857f7ea4dfdae723bc49ea530e,473077
2017-06-27 10:50:24,1.18445075,0.0,4.2165391,650672ef4e1bd4fe5b93c8e2d9b40e7bc95739a7a895c061848eeeed9da6b571,473079
2017-06-27 11:20:46,0.0,1.18445075,3.03208835,53483005f99aa3a5dd087942ecd1aea325743dc892f783b0f3911648ab50c138,473082
2017-06-27 12:58:52,0.0,3.03208835,0.0,5af3893f89ef06fbea360075a8df3f211d5cfc261ab55d81b46bfce0658ee99d,473093
2017-07-06 05:40:11,4.05231165,0.0,4.05231165,ffa48135dc27f0859fb60e0c285e20330f6398294cbfe04550666849c01ad6a6,474444
2017-07-06 06:02:36,0.0,4.05231165,0.0,b59d7026d8f8cc699734c737cc1c79a19420f3937923b9215d949fb7dfb70d6e,474447
2017-07-06 10:55:24,2.54357815,0.0,2.54357815,767b01ad9d27aa2c77e963522a41c857245fd9c46db772941a52a142f57e0b4f,474487
2017-07-06 11:59:45,0.0,2.54357815,0.0,dd2cbb0c04dc517228c062071e0ae942e80eec5175c79ed3c97a4314157a9828,474494
2017-07-20 07:22:28,0.3195,0.0,0.3195,ede5fbda2b0d764a43ab0da082e09fc600f0ee6cb0e8ce85a849fa5c46435482,476658
2017-07-20 07:42:03,0.0,0.3195,0.0,7612f8adf6dbb89f64bc2ae84ad745540399b087b5747bda8bb2195b583af81c,476661
2017-09-07 17:41:26,0.22325602,0.0,0.22325602,7ded3399e9c940adf8a7f78188511af554e44713ad309f1ffc8ac30abab52f3a,484035
2017-09-07 20:42:07,0.0,0.22325602,0.0,7eec7eff1c0e6952b41263ba1b4a5a3c6b055c88ac396d37f1b823e211386e2d,484059
2017-12-24 11:41:53,0.0232,0.0,0.0232,dc13494af46cd8c873f0b9ee7295c9b98259256b7041bdba2959de3a89b3f98b,500821
2017-12-24 12:18:27,0.0,0.0232,0.0,c04bdb88cf61eaabcf6633834ab40e851914e236417a2e8766d3a6fdf214b683,500824
