Time,Money-In,Money-Out,Balance,Txid,Block,input_n,output_n
2017-07-12,,0.03,-0.03,a5942d74b6f6538ae8a961f4e5f3ab91ec009cf8c3aa80e46c0ad6f169629f74,475613,1,20
2017-07-13,,0.03,-0.06,1a46bea28e68059080a84ea3bb22dadc0ce7941c2fce30cabc84535d57e2e74a,475576,1,20
2017-07-13,,0.03,-0.09,aee20165f9e4d2675e32ab762fe45ae05cd4bb79faa35b3c1ed704c9c954aca7,475772,1,20
2017-07-13,,0.03,-0.12,706510571348ccb73fc43ad8fb37d0fe1c1c75152a5c103706147c866a0f49e0,477100,1,20
2017-07-13,,0.03,-0.15,18102ef7d2885754474cf02adf179dacca1d548ab00517ebc7d25c8a0cb351d0,475613,1,20
2017-07-13,,0.03,-0.18,5297ea5fe8b6f6c7ba2297a5ae2a26f2767ecdeb681f4130bfbf9924b2842f5b,476339,1,20
2017-07-13,,0.03,-0.21,6e7cd00a8a246b5b4dffd58677dc45da9fc2af5730b906af208d487d1869845b,475772,1,20
2017-07-13,,0.03,-0.24,5b1748c4c3ca9950e6b7e0a390ec8aef518f05bed2e8d90acce966481e90d48b,475580,1,20
2017-07-13,,0.03,-0.27,6cd47e54b29cd85682fb9912614d2629132c237aaa4b67239fec81fdcef46c78,475636,1,20
2017-07-13,,0.03,-0.3,561e7e24094bea1fa87b64db7cdd6c150b591e653d137d275804f90f55baeda8,475655,1,20
2017-07-13,,0.03,-0.33,f7d41be3933bcea6e13a4371d51e1005736202979dc5e56ec47ebc22b7acb719,475590,1,20
2017-07-13,,0.03,-0.36,22705b5ca7f8fb50b5c3b9d49311700ca09fd52e1b65047fedc2c1712e343b56,475592,1,20
2017-07-13,,0.03,-0.39,d2773ff4a1744bda2761c8152af98b3b4fe65202f3706a0d0016056af3975f1d,475773,1,20
2017-07-13,,0.03,-0.42,af4eb221029977810809d08a52056e7482ffb495657555b326a7e192a53abb4a,475600,1,20
2017-07-13,,0.03,-0.45,f94720648f5a1d053b261ba15420243efaca4621801f2c5eedbdaacc95813f23,476972,1,20
2017-07-13,,0.03,-0.48,20067e01510452b7e59a2ac95b5a619b0c6830cdf2d43c42f36d932e730c48ae,475743,1,20
2017-07-13,,0.03,-0.51,0cb23256a5c111e1a2a5f3f5a58de019784ea3a00791037d67508283eeff11b9,477081,1,20
2017-07-13,,0.03,-0.54,2fcde7a8104f0765f1dc2b5c6d210857a0723c7205d664a0be1aadac5c8a6e6c,476182,1,20
2017-07-13,,0.03,-0.57,4c5e7945376a6fe9aa7ddc6e49b677c6a4164492a7ff1c5f24163651b13b0093,476360,1,20
2017-07-13,,0.03,-0.6,e2db2709ba3f58ea224854ee588e9db7ef6cde2a85a24fa9a83429064befb1c1,475598,1,20
2017-07-13,,0.0298,-0.6298,c4eae77a31107a0f7071872a0fe8ad2eee24abf252bc5d1199db195715c09f92,476955,1,20
2017-07-13,,0.0298,-0.6596,4a0a7adcc36e13282ddd0300103aff9373c8eaa016c4020d8bac32b0e474a4bf,476985,1,20
2017-07-13,,0.0298,-0.6894,ff99baf19c2dc67ae338fdf8e9b3db2ec5ec184941288db7999c7400d2f9fc53,476181,1,20
2017-07-13,,0.0298,-0.7192,09bf1f3562dccb6f26226491f53125b791c8e92d2f3386bbfaa4d247ee69530f,476181,1,20
2017-07-13,0.06,,-0.6592,a17691a5f8723b8c1b887c3ac80be6672d77dac17391661d167da4c670729137,475602,251,16
2017-07-13,,0.06,-0.7192,c36faaf9e029ee530f7e72f9cb3e86ed381f01086bcde21df6d4d4be06358feb,475610,2,2
2017-07-14,0.06,,-0.6592,0ed439d80fa113ca38cac48339137f6d85ab99ca4cccbd4b30befaa17ce0269f,475752,251,16
2017-07-14,,0.06,-0.7192,2a7af7c5633cda72fae42d3fbae875799904d73442bb136208ff7582566d80a5,475781,2,2
2017-07-15,0.06,,-0.6592,5f71b743116e34b494271cbc0d3bc02bcf34f2fd5d5678c5cdf43926bc25ccb1,475871,251,16
2017-07-15,,0.06,-0.7192,26b2f1bef374b5691e8340d2b0a8fb57d7ada6ea2b95e7fe27a839dfe4708ae7,475896,2,2
2017-07-18,0.06,,-0.6592,00ad10ba1e8e8f8f206d60ee75158a8b694466c431200e5de86bdf0acaf305b2,476343,251,15
2017-07-18,,0.06,-0.7192,10d646c4b94a5781502ac45f92fbe8a8f34bcac7c99a67b3fa8c32517c38cf19,476370,2,2
2017-07-20,0.06,,-0.6592,bde0159dd3b04b4721e47ba6cc9021dce2e7ac64b2180d44e2e1d8e9be109979,476676,251,25
2017-07-20,,0.06,-0.7192,98d5e7965901e3bf676875230ed70910d98e2c6fc98b6296ace9d2ca144636d4,476706,2,2
2017-07-22,0.06,,-0.6592,1d1b959313f3c865c649997cf112daacf8f96f2ba17dc067bd5eb918e7ff884f,477031,251,16
2017-07-22,,0.06,-0.7192,f1cada3db9fd36e51021cc4bf84c5390d0ea7dd98f5dc7664d3401808b3b2739,477051,2,2
2017-07-25,0.06,,-0.6592,caf8c455d408231b68371aa0bbc5d90a91ee14095979178257b6d9cdce70defc,477467,251,16
2017-08-04,,0.06,-0.7192,e3a242c3859dc47efd8e9664e23cda65c193bc88cd7c10221cdd29dff8a16e0e,479075,2,21
2017-08-08,0.03,,-0.6892,0ec2ad3e987bdc131396c1c235792ba3c220276e77398fc995b99f27ee10a37d,479562,251,2
2017-08-08,,0.03,-0.7192,ed6cf14cdf30309e3b1444e74a3965d03e31af72c1ccaab4907627f9b413edbe,482919,2,21
2017-08-09,0.03,,-0.6892,3224b81bd63cdc7e822752cc317f22a54d2b2607532ed0bd5d9ef88b452ac647,479737,251,8
2017-08-10,0.03,,-0.6592,20c4d15ba58c85504800573dde700e6baabe755e0cb15ea9a85be1c7caae5b38,479888,250,1
2017-08-11,0.03,,-0.6292,575ea115a2f9518259708f83660f0d1ef52b5969328a66b2e197fd4ef3773fe6,480001,251,8
2017-08-12,0.03,,-0.5992,8eba70c34beb9708427d9c8e76bd9b531d76793e07f32bcd1d44c3fc33cc0bbb,480138,251,10
2017-08-15,0.03,,-0.5692,e318d15a7bd82ba53fcf20a51c64e18222707ff70d6946aebb478415937a4139,480575,251,1
2017-09-11,,0.03,-0.5992,11b1aa6b5e87650d42217d9bda811b210ae33ae32e9034198395c47f8d9c5ddc,484698,2,31
2017-09-11,,0.03,-0.6292,9317c18ae52e13ba4f81d821a6d1e4223f2830a478e77e6fee58e751ec7b0e16,484699,2,31
2017-09-12,,0.03,-0.6592,55d6ae6f5b3f62e1e957bdcae3752d326b28f6068276a20bbdbfc70a62fe13c6,484731,2,31
2017-09-12,,0.03,-0.6892,aaab19b18db2ceb32dbb8e79de008282d9a557912cceec8bb89cd899c3ca9489,484740,2,31
2017-09-12,,0.03,-0.7192,68133ca4d2229d40aa618b88897d7f46428e3d3d0cc7f9b1eb73a638ba1f7e19,484741,2,31
